SO ./textures/cluster1.png

EA ./textures/banana.png

NO  ./textures/north_test.png

WE ./textures/orange_bricks_high_reZ.png

C      111, 12, 231
F 1,111,100,

           
  111111111111
  1E0000101  1
  111101101  1
    110100111
  110000001
  100111101
  1111  111