SO ./textures/south.png

EA ./textures/east.png

NO  ./textures/north.png

WE ./textures/west.png

C      111, 12, 231
F 1,111,100,


1111111
11110N1
1111111
1111
1
1
1
1111