SO ./textures/south.png

EA ./textures/east.png

NO  ./textures/north.png

WE ./textures/west.png

C      111, 12, 231
F 1,111,100,


11111111111111111111111111111111
1111101100000000100000000000001
111111101100000111000000000000111
111111111000000000000000000000001111111111
1111111100000000111000000000000111111111011
1000000001100000111011111111111111111111111
111100011111110111000000100011
111100011110000111011010010001
110000111111001111000000100001
100000100111101100000010001111
100000111110000001000100100011
110000011101101111001111000111
1111011111110001110010000001
11111111111100111111111111111
1111111111110011111111111111
1111110000000W00000001111111
1111111111111111111111111111
