SO ./textures/south.png

EA ./textures/east.png

NO  ./textures/north.png

WE ./textures/west.png

C      111, 12, 231
F 1,111,100,


1111111111111
10000000N1111
1111111111111