SO ./path_to_the_north_texture
C 122, 111, 12

EA ./path_to_the_east_texture



NO  ./path_to_the_south_texture
WE  ./path_to_the_west_texture

F 1,111,100,

                1111
                1111
                1111
        111
        101
        111
                 11
        1111111110011111111111111
        100000000100000000000001111
        111011000001110000000000001
        1E0000000000000000000000111
11111111011000001110000000000001
10000000011000001110111111111111
111100011111110111000000100011
111100011110111111011010010001
110000111111001111000000100001
1000001  111101100000010001111
100000111110000011010100100011
110000011101101111101111000111
11110111111101011101111010001
11111111111111111111111111111

1111                   1111
1001                   1001
1111                   1111