NO ./path_to_the_north_texture
EA  ./path_to_the_east_texture
SO  ./path_to_the_south_texture
WE  ./path_to_the_west_texture

F 222,102,210
C 122,11,111

        111111111111111111111111
        101110000011000000000000111
        111011000001110000000000001
        100000000000000000000000111
111111111011000001110000000000001
1W0000000011000001110111111111111
11110111111111011100000010001
11110111111111111101010010001
11000011111100111100000010001
1000001   111101100000010001
10000011111000001101010010001
1100000111010101111101111000111
11110111111101011101111010001


11111111111111111111111111111



1101                   1101
1001                   1001
1111                   1111