SO ./textures/south_test.png

EA ./textures/east_test.png

NO  ./textures/north_test.png

WE ./textures/west_test.png

C      111, 12, 231
F 1,111,100,


1111111111111
10000000N1111
100000001111
100000001111
1100000001111
111000000011
10000000111111
11100000001111
1111111111111