C 225,30,0
NO  ./path_to_the_north_texture
EA  ./path_to_the_east_texture

SO  ./path_to_the_south_texture
F 2290,102,0
WE  ./path_to_the_west_texture
        1111111111111111111111111
        100000000011000000000000111
        111011000001110000000000001
        100000000000000000000000111
111111111011000001110000000000001
1W0000000011000001110111111111111
11110111111111011100000010001
11110111111111111101010010001
11000011111100111100000010001
1000001   111101100000010001
10000011111000001101010010001
1100000111010101111101111000111
11110111 1110101 101111010001
11111111 1111111 111111111111