SO ./textures/cluster1.png

EA ./textures/banana.png

NO  ./textures/north_test.png

WE ./textures/orange_bricks_high_reZ.png

C      111, 12, 231
F 1,111,100,


1111111111111
10000000S11111111111111111111111111111111111111111111111111111111111111111111111111111111111111111111111111111
10000000000000000000000000000000000000000000000000000000000000000000000000000000000000000000000000000000000001
10000000001111111111111111111111111111111111111111111111111111111111110011111111111111111111111111111111111111
1111111110111111111111111111111111111111111111111111111111111111111111001
11111  110111111111111111111111111111111111111111111111111111111111111001
1000111110111111111111111111111111111111111111111111111111111111111111001
1100000000111111111111111111111111111111111111111111111111111111111111001
1110000000111111111111111111111111111111111111111111111111111111111111001
1000000011111111111111111111111111111111111111111111111111111111111111001
1110000000000000000000000000000000000000000000000000000000000000000000001
1111111111111111111111111111111111111111111111111111111111111111111111111