SO ./textures/cluster1.png

EA ./textures/banana.png

NO  ./textures/north_test.png

WE ./textures/orange_bricks_high_reZ.png

C      111, 12, 231
F 1,111,100,


1111111111111
10000000S11111111111111111111111111111111111111111111111111111111111111111111111111111111111111111111111111111111111111111111111111111111111111111111111111111111111111111111111111111111111111111111111111111111
10000000000000000000000000000000000000000000000000000000000000000000000000000000000000000000000000000000000000000000000000000000000000000000000000000000000000000000000000000000000000000000000000000000001
10000000001111111111111111111100111111111111111111111111111111111111110011111111111111111111111111111111111111111111111111111111111111111111111111111111111111111111111111111111111111111111111111000000001
111111111011111111111111 111 1001      1111111111111111111111111111111001                                                                                                                        100000000111
11111  11011111111111111 111 100111111 1111111111111111111111111111111001                                                                                                                        110010100001
100011111011111111111111     1001      1111111111111111111111111111111001                                                                                                                        100010100111
1100000000111111111111111111 1001 111111111111111111111111111111111111001                                                                                                                        1000111001
1110000000111111111111111111 1001 111111111111111111111111111111111111001                                                                                                                        1000001001
1000000011111111111111111111 1001      1111111111111111111111111111111001                                                                                                                        1000001001
11111110111111111111111111111100111111111111111111111111111111111111110011111111111111111111111111111111111111111111111111111111111111111111111111111111111111111111111111111111111111111111111111000000001
11100000000000000000000000000000000000000000000000000000000000000000000000000000000000000000000000000000000000000000000000000000000000000000000000000000000000000000000000000000000000000000000000000000001
11111111111111111111111111111111111111111111111111111111111111111111111111111111111111111111111111111111111111111111111111111111111111111111111111111111111111111111111111111111111111111111111111111111111