NO ./path_to_the_north_texture

C 122, 111, 12



EA  ./path_to_the_east_texture



SO  ./path_to_the_south_texture


WE  ./path_to_the_west_texture

F 2,111,10



                 1
                1S1
        1111111110011111111111111
        10000000010000000000000111
        111011000001110000000000001
        100000000000000000000000111
111111111011000001110000000000001
10000000011000001110111111111111
11110001111111011100000010001
111100011110111111011010010001
11000011111100111100000010001
1000001  11110110000001000111
10000011111000001101010010001
110000011101101111101111000111
11110111111101011101111010001
11111111111111111111111111111

1111                   1111
1001                   1001
1111                   1111